F 20  ,  50  , 222

C 10   ,10,   100,
 
NO textures/0.xpm
EA textures/1.xpm
SO textures/2.xpm

WE textures/3.xpm

   11111111111111111111111111         
   100000N0000000000000001      
  1000000000000001000000001      
 1000000000000000000000001
1000000111111111100000111
 1000001111111111000000001
  1000011111111110000000011
   1000000000000000000000001
  1000000000000000000000001      1
 1000000000000000000000001
11111111111111111111111111
111


1
