NO textures/wood.xpm
SO textures/colorstone.xpm

WE textures/greystone.xpm


EA textures/redbrick.xpm

F  0,80,0
C  0,0,210

1111111111111111111111111
1000000000000000000000001
1000000000000000000000011
10000000000S000000000001
10000000000000000000001
1000000000000000000000111
1000000000000000000000001
11111111111111111111111111





