F 20  ,  50  , 222

C 10   , 10,   100
 
NO textures/2.xpm
SO textures/0.xpm

EA textures/1.xpm
WE textures/3.xpm

111111111111111111111111111111
                             1
1111111111111111111111111    1 
10000000000000000000000001    1
111110000000000000000000001   1
100000000000000000000000111   1
100000000000000000000001111   1
1000110000000000000000000011  1
100000000000000000000000001   1
100000000000000000000000001   1
100000000000W00000000000001   1
100000000000000000000000001   1
100000000000000000000000001   1  
100000000000000000000000001   1 
100000000000000000000000001   1
100000000000000000000000001   1
100000000000000000000000001   1
100000000000000000000000001   1
100000001000100100000000001   1
1000000010001001000000000011   1            
100000001000100100000000001     1       
11111111111111111111111111111111 