SO textures/2.xpm

F 20,50       ,4
C 10,4,5
 
NO textures/0.xpm

EA textures/1.xpm
WE textures/3.xpm

1111111111111111111111111111111111111
  1  11111111111111111111111111    1
  1  10000000000000000000000001    1
  1  111110000000000000000000001   1
  1  100000000000000000000000111   1
  1  100000000000000000000001111   1
      10000000000000000000011  1
1111111000000000000000000001   1 
100000000000000000000000011   
100000000000000000000000001   
100000000001100000000000111111
10000000000N000000000000001   1  
100000000000000000000000001   1 
100000000000000000000000001   1
100000000000000000000000001   1
100000000000000000000000001   1
100000000000000000000000001   1
100000001000100100000000001   1
1000000010001001000000000011  1
100000001000100100000000001   1
1111111111111111111111111111  11 
                      

                   
