NO ./textures/wall_1.xpm
SO ./textures/wall_2.xpm
WE ./textures/wall_3.xpm
EA ./textures/wall_4.xpm


F 220,100,0
C 225,30,0

111111111111111111111111111
100000000000000000000000001
111110000000000000000000011
100000000000000000000000111
100000000000000000000001111
100000000000000000000000011
100000000011111100000000001
100000000000000000000000001
1000000000000100001100000001
1000000000010W00000000000001
100000000000000000000000001
100000000000000000000000001
100000000000000000000000001
100000000000000000000000001
100000000000000000000000001
100000000000000000000000001
100000001000100100000000001
100000001000100100000000001
100000001000100100000000001
111111111111111111111111111
