NO /Users/havyilma/Desktop/cub3d/textures/wood.xpm  
SO /Users/havyilma/Desktop/cub3d/textures/colorstone.xpm

WE /Users/havyilma/Desktop/cub3d/textures/greystone.xpm


EA /Users/havyilma/Desktop/cub3d/textures/redbrick.xpm

F  100,0,0
C  0,0,130

1111111111111111111111111
1000001000000000001111111
100100100001000000000S00011
10010010000000001111111111
10010000000000000000000001
11110000100000000000000111
111111111111111111111111111111





