C 10,10,100

NO textures/0.xpm
EA textures/1.xpm
SO textures/2.xpm
WE textures/3.xpm
     
	 
F 20,50,10




11111111111111111111111111111
10010000000000000000000001001
10000000000000000000000000001    
11000000011111111110000000011
10000100000000000000000100001
10000100000011110000000100001
10000100000000000000000100001
11111000000001100000000011111
10000100000000000000000100111
10000100000011110000000100001
1000010000000N000000000100001
11000000001111111100000000011
10000000000000000000000000001
10010000000000000000000001001        
11111111111111111111111111111
