EA textures/wall_4.xpm
NO textures/wall_1.xpm

F 184,113,39 
   SO textures/wall_2.xpm
WE textures/wall_3.xpm          

C    51,198,42


111111111111
10000010W001
100100100001
100100100001
100100000001
111111111111
