NO textures/wood.xpm
SO textures/colorstone.xpm

WE textures/greystone.xpm


EA textures/redbrick.xpm

F  0,80,0
C  0,0,210

1111111111111111111111111
10000010000000000000000011
100100100001000000000S0011
100100100000000000000100011
10010000000000000000000001
11110000100000000000000111
111111111111111111111111111111





