NO ./textures/1-64.xpm
SO ./textures/2-64.xpm            
WE ./textures/3-64.xpm 
EA ./textures/4-64.xpm


F 155,55,55
C 100,20,20

        1111111111111111111111111
        1000000000110000000000001
        1011000001110000000000001
        1001000000000000000000001
111111111011000001110000000000001
10000000001100000111011111111111
11110111111111011100000010001
11110111111111011101010010001
11000000110100000000000010001
10000000000000000000000000001
10000000000000001101010010011
11000001110101011111011110N1111
11110111 1110101 101111010001
11111111 1111111 111111111111

