F 20  ,  50  , 222

C 10   , 10,   100
 
NO textures/2.xpm
SO textures/0.xpm

EA textures/1.xpm
WE textures/3.xpm
111
1011111111111111111111111
10000000000000000000000001
111110000000000000000000001
100000000000000000000000111
100000000000000000000001111
1000110000000000000000000011
100000000000000000000000001
100000000000000000000000001
100000000000W00000000000001
100000000000000000000000001
100000000000000000000000001
100000000000000000000000001
100000000000000000000000001
100000000000000000000000001
100000000000000000000000001
1000000000000000000000000011
100000001000100100000000001011111111111
1000000010001001000000000011               
100000001000100100000000001           
111111111111111111111111111           
