EA textures/wall_4.xpm
NO textures/wall_1.xpm

F 184,113,39 
   SO textures/wall_2.xpm
WE textures/wall_3.xpm          

C    51,198,42,


1111111111     111
1000000001     101
1111000001     111
1000000001
100NN01001
101000W011
100000000111111111
111111100000000001
      100000111001
      100000001001
      100011111001
      100001100001
      100001000001
      111111111111
                       1111111
